5
8
OOXOOOOO
XOOOXOXO
XOOOXOXO
XOOOXOXO
OOOOOOXO