10
10
OOOXXXOOOO
OXOXXXXXXX
XOOXXXOXXO
XXOXOXOXXX
XOOOOOOOXX
XXOOOXXOXX
XXOXXXXOXO
XXOOOOOOOO
XOOXOXOXOO
XOXXOOOXXO